           -----------------------------------------------------------------------------------------
          ------------------------------------------------------------------------------------------
         -------------------------------------------------------------------------------------------
        --------------------------------------------------------------------------------------------
       ---------------------------------------------------------------------------------------------
      ----------------------------------------------------------------------------------------------
     -----------------------------------------------------------------------------------------------
    ------------------------------------------------------------------------------------------------
   -------------------------------------------------------------------------------------------------
  --------------------------------------------------------------------------------------------------
 ---------------------------------------------------------------------------------------------------
--------------------------------MMM------------------------------MMM--------------------------------
---------------------------------VM-------------------------------VM--------------------------------
--------------------------------MMM------------------------------MMM--------------------------------
----------------------------------------------------------------------------------------------------
----------------------------------------------------------------------------------------------------
----------------------------------------------------------------------------------------------------
----------------------------------------------------------------------------------------------------
----------------------------------------------------------------------------------------------------
----------------------------------------------------------------------------------------------------
----------------------------------------------------------------------------------------------------
----------------------------------------------------------------------------------------------------
----------------------------------------------------------------------------------------------------
----------------------------------------------------------------------------------------------------
--------------------------------MMM------------------------------MMM--------------------------------
----- ---------------------------VM-------------------------------VM--------------------------------
----   -------------------------MMM------------------------------MMM--------------------------------
---     --------------------------------------------------------------------------------------------
--       -------------------------------------------------------------------------------------------
-         ------------------------------------------------------------------------------------------
           -----------------------------------------------------------------------------------------
            ----------------------------------------------------------------------------------------
             ---------------------------------------------------------------------------------------
              --------------------------------------------------------------------------------------
             ---------------------------------------------------------------------------------------
            --------------------------------------------------------------------------------------- 
           ---------------------MMM------------------------------MMM------------------------------  
-         -----------------------VM-------------------------------VM-----------------------------   
--       -----------------------MMM------------------------------MMM----------------------------    
---     ---------------------------------------------------------------------------------------     
----   ---------------------------------------------------------------------------------------      
----- ---------------------------------------------------------------------------------------       
--------------------------------------------------------------------------------------------        
-------------------------------------------------------------------------------------------         
------------------------------------------------------------------------------------------          
-------------------------------------------------- --------------------------------------           
-------------------------------------------------   ------------------------------------            
------------------------------------------------     ----------------------------------             
-----------------------------------------------       --------------------------------              
----------------------------------------------         ------------------------------               
---------------------------------------------           ----------------------------                
----------------------------------------------         ------------------------------               
-----------------------------------------------       --------------------------------              
------------------------------------------------     ----------------------------------             
-------------------------------------------------   ------------------------------------            
-------------------------------------------------- --------------------------------------           
------------------------------------------------------------------------------------------          
-------------------------------------------------------------------------------------------         
--------------------------------------------------------------------------------------------        
---------------------------------------------------------------------------------------------       
----------------------------------------------------------------------------------------------      
--------------------------------MMM------------------------------MMM---------------------------     
---------------------------------VM-------------------------------VM----------------------------    
--------------------------------MMM------------------------------MMM-----------------------------   
--------------------------------------------------------------------------------------------------  
--------------------------------------------------------------------------------------------------- 
----------------------------------------------------------------------------------------------------
----------------------------------------------------------------------------------------------------
----------------------------------------------------------------------------------------------------
----------------------------------------------------------------------------------------------------
----------------------------------------------------------------------------------------------------
----------------------------------------------------------------------------------------------------
-------------------------------------------------- -------------------------------------------------
-------------------------------------------------   ------------------------------------------------
--------------------------------MMM-------------     ------------MMM--------------------------------
---------------------------------VM------------       ------------VM--------------------------------
--------------------------------MMM-------------     ------------MMM------------------------------- 
-------------------------------------------------   ----------------------------------------------  
-------------------------------------------------- ----------------------------------------------   
------------------------------------------------------------------------------------------------    
-----------------------------------------------------------------------------------------------     
------------------------------------------------------------------------------------------------    
-------------------------------------------------------------------------------------------------   
--------------------------------------------------------------------------------------------------  
--------------------------------------------------------------------------------------------------- 
----------------------------------------------------------------------------------------------------
--------------------------------MMM------------------------------MMM--------------------------------
---------------------------------VM-------------------------------VM--------------------------------
--------------------------------MMM------------------------------MMM--------------------------------
----------------------------------------------------------------------------------------------------
----------------------------------------------------------------------------------------------------
----------------------------------------------------------------------------------------------------
----------------------------------------------------------------------------------------------------
----------------------------------------------------------------------------------------------------
--------------- ------------------------------------------------------------------------------------
--------------   -----------------------------------------------------------------------------------
-------------     ----------------------------------------------------------------------------------
------------       ---------------------------------------------------------------------------------
-----------         --------------------------------------------------------------------------------
----------           -------------------------------------------------------------------------------